NO ./textures/ac007c51eea4b4bc24500d579b7a8428.png
SO ./textures/images.png
WE ./textures/maxresdefault.png
EA ./textures/311.png


F 78,55,254
C 120,78,86

1111111111111111111111111
1000000000110000000000001
1011000001110000000000001
10010000000000000000000011
10010000000000000000000001
10010000000000000000000011
1111111110110000011100001
1000000000110000011101111
1111011111111101110000001
1111111111111101110101001
11010100110101011100000011
100101100000000S11000000011
10000100000000001101010011
1100000111010101111101111
11110111111101011011110111
11111111110111111111111111
11111111111111111111111111