NO ./path_to_the_north_texture
SO ./path_to_the_south_texture
WE ./path_to_the_west_texture
EA ./path_to_the_east_texture

F 220,100,0
C 225,30,0

        1111111111111111111111111
        1000000000110000000000001
        1011000001110000000000001
        1001000000000000000000001
111111111011000001110000000000001
100000000011000001110111111111111
111101111111110111000000100011
1111111111111101110101001000101
110101001101010111000000100011
1001S11000000000110000001110111
10000100000000001101010011110001
1100000111010101111101111101111
11110111 1110101101111010001
11111111 1111111 1111111111111