        1111111111111111111111111
        1000000000110000000000001
        1011000001110000000000001
        1001000000000000000000001
111111111011000001110000000000001
100000000011000001110111111111111
11110111111111011100000010001
11111111111111011101010010001
11010100110101011100000010001
1001S11000000000110000001110111
10000100000000001101010011110001
1100000111010101111101111101111
11110111 1110101101111010001
11111111 1111111 111111111111