NO ./textures/ac007c51eea4b4bc24500d579b7a8428.png
SO ./textures/images.png
WE ./textures/maxresdefault.png
EA ./textures/311.png

F   8,55,255    
C 120,78,86

        1111111111111111111111111
        1000000000110000000000001
        1011000001110000000000001
        1001000000000000000000001
111111111011000001110000000000001
10000000001100N001110111111111111
11110111111111011100000010001
11110111111111011101010010001
11000000110101011100000010001
10000000000000001100000010001
10000000000000001101010010001
1100000111010101111101111000111
11110111 1110101 101111010001
11111111 1111111 111111111111