NO ./path_to_the_north_texture
SO ./path_to_the_south_texture
WE ./path_to_the_west_texture
EA ./path_to_the_east_texture

F 220,100,0
C 225,30,0

    1111111111111111
    1000000000000111       
    1000000S00000111
    1000000000000111
    1000000000000111
11110001000000001
1111111 111111111