NO ./textures/TECH_0E.png
SO ./textures/TECH_1F.png
WE ./textures/SUPPORT_1A.png
EA ./textures/CONCRETE_1A.png

F 9,11,11
C 25,27,28

1111111111111111111111111
1000000001100000000000011
1111111110000011100000001
1001000000000000000000001
111111111011000001110000111111111111
100000000011000001110111111111111
111101111111110111000000100011
1111011111111101 101010010001
11000000110101011100000010001
10000000000000001100000010001
10000000000000000101010011101
110000011101010101010110N0111
111101111110101100011010001
111111111111111111111111111